%%%%%%%%%%%
%         %
%         %
%         %
%         %
%         %
%         %
%         %
%         %
%         %
% RBR BBR %
% R.B BGB %
% B B R R %
%P        %
%%%%%%%%%%%