%%%%%%%%%%%%%%%
%             %
% RBB         %
% BGB         %
% B R         %
%             %
%         RBR %
%         B.R %
%         B R %
%P            %
%%%%%%%%%%%%%%%
