%%%%%%%%%%%
%         %
% RRB     %
% RGR     %
% R B     %
%         %
%     RRR %
%     B.B %
%     B B %
%P        %
%%%%%%%%%%%