%%%%%%%%%%%
%         %
% RBR BRR %
% BGR B.R %
% R B B B %
%    P    %
%         %
%         %
%         %
%         %
%%%%%%%%%%%
