%%%%%%%%%%%%%%%%%%%
%                 %
%             BRR %
%             RGB %
%             R B %
%                 %
%                 %
%                 %
%                 %
%                 %
% BBB             %
% R.B             %
% B B             %
%P                %
%%%%%%%%%%%%%%%%%%%